:level1
##################################
.................................#
..............###############....#
.............#..............##...#
................................##
#....###........................##
#...........##################.###
#.................##............##
#.#######.........##............##
#.......##........##............##
######..#.........##............##
#.......####.....###............##
#..######.......####............##
#..............#####............##
##########....######............##
..........#.....................##
................................##
.............###................##
................................##
.........##.....................##
................................##
................................##
###################............P##
##################################