:level1
#################################
.................................
..............###############...#
.............#..............##...
................................#
#....###........................#
#...........#####################
#.................##
#.#######.........##
#.......##........##
######..#.........##
#.......####.....###
#..######.......####
#..............#####
##########....######
..........#..........
....................
.............###.....
....................
.........##.........
....................
....................
####################
##################################