:level1
####################
....................
..............######
....................
....................
#....###............
#............#######
#.................##
#.#######.........##
#.......##........##
######..#.........##
#.......####.....###
#..######.......####
#..............#####
####################
....................